1 1 1 1 1 1 1 1 1 1 1 1 1 1 1 1
1 0 0 0 0 0 0 0 0 0 0 0 0 0 0 1
1 0 4 4 0 7 8 9 0 0 3 3 3 0 0 1
1 0 4 4 0 10 11 11 12 0 3 3 3 0 0 1
1 0 0 0 0 0 0 0 0 0 3 3 3 0 0 1
1 0 0 0 0 0 0 0 0 0 0 0 0 0 0 1
1 0 0 0 0 5 5 5 5 5 5 0 0 0 0 1
1 0 0 0 0 5 2 2 2 2 5 0 6 6 0 1
1 0 0 0 0 5 2 2 2 2 5 0 6 6 0 1
1 0 0 0 0 5 2 2 2 2 5 0 0 0 0 1
1 0 0 0 0 5 2 2 2 2 5 0 0 0 0 1
1 1 1 1 1 1 1 1 1 1 1 1 1 1 1 1